50 50
9 9 8 8 8 7 7 7 6 6 5 5 5 4 4 4 5 5 6 6 7 7 8 8 9 9 10 10 9 9 8 7 7 6 5 5 4 4 3 3 2 2 3 4 5 6 7 8 8 9
9 8 8 8 7 7 7 6 6 5 5 4 4 4 3 4 4 5 5 6 6 7 7 8 8 9 9 9 9 8 8 7 6 6 5 4 4 3 3 2 2 2 3 4 5 6 7 7 8 8
8 8 8 7 7 6 6 6 5 5 4 4 3 3 3 3 4 4 5 5 6 7 7 8 8 9 9 10 9 8 7 7 6 5 5 4 3 3 2 2 1 2 3 4 5 6 6 7 8 8
8 8 7 7 6 6 6 5 5 4 4 3 3 2 2 3 3 4 5 5 6 6 7 8 9 9 10 10 9 8 7 6 5 5 4 3 3 2 2 1 1 2 3 4 5 5 6 7 7 8
8 7 7 6 6 5 5 5 4 4 3 3 2 2 2 2 3 4 4 5 6 6 7 8 8 9 10 9 9 8 7 6 5 4 4 3 2 2 1 1 1 2 3 4 4 5 6 7 7 8
7 7 6 6 5 5 4 4 4 3 3 2 2 1 1 2 3 3 4 5 5 6 7 7 8 9 9 9 8 7 6 5 5 4 3 2 2 1 1 0 1 2 3 4 4 5 6 6 7 7
7 6 6 5 5 4 4 3 3 3 2 2 1 1 1 2 2 3 4 4 5 6 6 7 8 8 9 8 8 7 6 5 4 3 3 2 1 1 0 0 1 2 3 3 4 5 5 6 7 7
6 6 5 5 4 4 3 3 2 2 2 1 1 0 1 1 2 3 3 4 5 5 6 7 7 8 8 8 7 6 5 4 3 3 2 1 1 0 0 0 1 2 2 3 4 4 5 6 6 7
6 5 5 4 4 3 3 2 2 1 1 1 0 0 0 1 2 2 3 4 4 5 6 6 7 8 8 7 7 6 5 4 3 2 1 1 0 0 0 0 1 1 2 3 3 4 5 5 6 6
5 5 4 4 3 3 2 2 1 1 0 0 0 0 0 1 1 2 3 3 4 5 5 6 7 7 7 7 6 5 4 3 2 2 1 0 0 0 0 0 0 1 2 2 3 4 4 5 6 6
5 4 4 3 3 2 2 1 1 0 0 0 0 0 0 0 1 2 2 3 4 4 5 6 6 7 7 6 6 5 4 3 2 1 1 0 0 0 0 0 0 1 1 2 3 3 4 5 5 6
4 4 3 3 2 2 1 1 0 0 0 0 0 0 0 0 1 1 2 3 3 4 5 5 6 6 6 6 5 4 3 2 1 1 0 0 0 0 0 0 0 0 1 2 2 3 4 4 5 5
4 3 3 2 2 1 1 0 0 0 0 0 0 0 0 0 0 1 2 2 3 4 4 5 5 6 6 5 5 4 3 2 1 0 0 0 0 0 0 0 0 0 1 1 2 3 3 4 5 5
3 3 2 2 1 1 0 0 0 0 0 0 0 0 0 0 0 1 1 2 3 3 4 5 5 5 5 5 4 3 2 1 1 0 0 0 0 0 0 0 0 0 0 1 2 2 3 4 4 5
3 2 2 1 1 0 0 0 0 0 0 0 0 0 0 0 0 0 1 2 2 3 4 4 5 5 5 4 4 3 2 1 0 0 0 0 0 0 0 0 0 0 0 1 1 2 3 3 4 4
2 2 1 1 0 0 0 0 0 0 0 0 0 0 0 0 0 0 1 1 2 3 3 4 4 5 4 4 3 2 1 1 0 0 0 0 0 0 0 0 0 0 0 0 1 2 2 3 4 4
2 1 1 0 0 0 0 0 0 0 0 0 0 0 0 0 0 0 0 1 2 2 3 4 4 4 4 3 3 2 1 0 0 0 0 0 0 0 0 0 0 0 0 0 1 1 2 3 3 4
1 1 0 0 0 0 0 0 0 0 0 0 0 0 0 0 0 0 0 1 1 2 3 3 4 4 3 3 2 1 1 0 0 0 0 0 0 0 0 0 0 0 0 0 0 1 2 2 3 3
1 0 0 0 0 0 0 0 0 0 0 0 0 0 0 0 0 0 0 0 1 2 2 3 4 3 3 2 2 1 0 0 0 0 0 0 0 0 0 0 0 0 0 0 0 1 1 2 3 3
1 0 0 0 0 0 0 0 0 0 0 0 0 0 0 0 0 0 0 0 1 1 2 3 3 3 2 2 1 1 0 0 0 0 0 0 0 0 0 0 0 0 0 0 0 0 1 2 2 3
1 0 0 0 0 0 0 0 0 0 0 0 0 0 0 0 0 0 0 0 0 1 2 2 3 2 2 1 1 0 0 0 0 0 0 0 0 0 0 0 0 0 0 0 0 0 1 1 2 2
1 0 0 0 0 0 0 0 0 0 0 0 0 0 0 0 0 0 0 0 0 1 1 2 2 2 1 1 0 0 0 0 0 0 0 0 0 0 0 0 0 0 0 0 0 0 0 1 1 2
1 1 0 0 0 0 0 0 0 0 0 0 0 0 0 0 0 0 0 0 1 1 2 2 2 2 1 1 0 0 0 0 0 0 0 0 0 0 0 0 0 0 0 0 0 0 1 1 2 2
2 1 1 0 0 0 0 0 0 0 0 0 0 0 0 0 0 0 0 1 1 2 2 3 3 2 2 1 1 0 0 0 0 0 0 0 0 0 0 0 0 0 0 0 0 1 1 2 3 3
2 2 1 1 0 0 0 0 0 0 0 0 0 0 0 0 0 0 1 1 2 2 3 3 4 3 3 2 1 1 0 0 0 0 0 0 0 0 0 0 0 0 0 0 1 1 2 3 3 4
3 2 2 1 1 0 0 0 0 0 0 0 0 0 0 0 0 1 1 2 2 3 3 4 4 4 3 3 2 1 1 0 0 0 0 0 0 0 0 0 0 0 0 1 1 2 3 3 4 4
3 3 2 2 1 1 0 0 0 0 0 0 0 0 0 0 1 1 2 2 3 3 4 4 5 4 4 3 2 2 1 1 0 0 0 0 0 0 0 0 0 0 1 1 2 3 3 4 5 5
4 3 3 2 2 1 1 0 0 0 0 0 0 0 0 1 1 2 2 3 3 4 4 5 5 5 4 4 3 2 2 1 1 0 0 0 0 0 0 0 0 1 1 2 3 3 4 5 5 6
4 4 3 3 2 2 1 1 0 0 0 0 0 0 1 1 2 2 3 3 4 4 5 5 6 5 5 4 3 3 2 1 1 0 0 0 0 0 0 0 1 1 2 3 3 4 5 5 6 6
5 4 4 3 3 2 2 1 1 0 0 0 0 1 1 2 2 3 3 4 4 5 5 6 6 6 5 5 4 3 2 2 1 1 0 0 0 0 0 1 1 2 3 3 4 5 5 6 6 7
5 5 4 4 3 3 2 2 1 1 0 0 1 1 2 2 3 3 4 4 5 5 6 6 7 6 6 5 4 3 3 2 1 1 0 0 0 0 1 1 2 3 3 4 5 5 6 6 7 7
6 5 5 4 4 3 3 2 2 1 1 1 1 2 2 3 3 4 4 5 5 6 6 7 7 7 6 6 5 4 3 2 2 1 1 0 0 1 1 2 3 3 4 5 5 6 6 7 7 8
6 6 5 5 4 4 3 3 2 2 1 1 2 2 3 3 4 4 5 5 6 6 7 7 8 7 7 6 5 4 3 3 2 2 1 1 1 1 2 3 3 4 5 5 6 6 7 7 8 8
7 6 6 5 5 4 4 3 3 2 2 2 2 3 3 4 4 5 5 6 6 7 7 8 8 8 7 7 6 5 4 3 3 2 2 1 1 2 3 3 4 5 5 6 6 7 7 8 8 9
7 7 6 6 5 5 4 4 3 3 2 2 3 3 4 4 5 5 6 6 7 7 8 8 9 8 8 7 6 5 5 4 3 3 2 2 2 3 3 4 5 5 6 6 7 7 8 8 9 9
8 7 7 6 6 5 5 4 4 3 3 3 3 4 4 5 5 6 6 7 7 8 8 9 9 9 8 8 7 6 5 4 4 3 3 2 3 3 4 5 5 6 6 7 7 8 8 9 9 10
8 8 7 7 6 6 5 5 4 4 3 3 4 4 5 5 6 6 7 7 8 8 9 9 10 9 9 8 7 6 5 5 4 4 3 3 3 4 5 5 6 6 7 7 8 8 9 9 10 10
9 8 8 7 7 6 6 5 5 4 4 4 4 5 5 6 6 7 7 8 8 9 9 10 10 10 9 9 8 7 6 5 5 4 4 3 4 5 5 6 6 7 7 8 8 9 9 10 10 10
9 9 8 8 7 7 6 6 5 5 4 4 5 5 6 6 7 7 8 8 9 9 10 10 10 10 10 9 8 7 6 6 5 5 4 4 5 5 6 6 7 7 8 8 9 9 10 10 10 9
10 9 9 8 8 7 7 6 6 5 5 5 5 6 6 7 7 8 8 9 9 10 10 10 10 10 10 9 9 8 7 6 6 5 5 5 5 6 6 7 7 8 8 9 9 10 10 10 9 9
10 10 9 9 8 8 7 7 6 6 5 5 6 6 7 7 8 8 9 9 10 10 10 10 10 10 9 9 8 8 7 7 6 6 5 5 6 6 7 7 8 8 9 9 10 10 10 9 9 8
10 10 10 9 9 8 8 7 7 6 6 6 6 7 7 8 8 9 9 10 10 10 10 10 10 9 9 8 8 7 7 6 6 5 5 6 6 7 7 8 8 9 9 10 10 10 9 9 8 8
9 10 10 10 9 9 8 8 7 7 6 6 7 7 8 8 9 9 10 10 10 10 10 10 9 9 8 8 7 7 6 6 5 5 6 6 7 7 8 8 9 9 10 10 10 9 9 8 8 7
9 9 10 10 10 9 9 8 8 7 7 7 7 8 8 9 9 10 10 10 10 10 10 9 9 8 8 7 7 6 6 5 5 6 6 7 7 8 8 9 9 10 10 10 9 9 8 8 7 7
8 9 9 10 10 10 9 9 8 8 7 7 8 8 9 9 10 10 10 10 10 10 9 9 8 8 7 7 6 6 5 5 6 6 7 7 8 8 9 9 10 10 10 9 9 8 8 7 7 6
8 8 9 9 10 10 10 9 9 8 8 8 8 9 9 10 10 10 10 10 10 9 9 8 8 7 7 6 6 5 5 6 6 7 7 8 8 9 9 10 10 10 9 9 8 8 7 7 6 6
7 8 8 9 9 10 10 10 9 9 8 8 9 9 10 10 10 10 10 10 9 9 8 8 7 7 6 6 5 5 6 6 7 7 8 8 9 9 10 10 10 9 9 8 8 7 7 6 6 5
7 7 8 8 9 9 10 10 10 9 9 9 9 10 10 10 10 10 10 9 9 8 8 7 7 6 6 5 5 6 6 7 7 8 8 9 9 10 10 10 9 9 8 8 7 7 6 6 5 5
6 7 7 8 8 9 9 10 10 10 9 9 10 10 10 10 10 10 9 9 8 8 7 7 6 6 5 5 6 6 7 7 8 8 9 9 10 10 10 9 9 8 8 7 7 6 6 5 5 4
6 6 7 7 8 8 9 9 10 10 10 10 10 10 10 10 10 9 9 8 8 7 7 6 6 5 5 6 6 7 7 8 8 9 9 10 10 10 9 9 8 8 7 7 6 6 5 5 4 4
34.0 10.0
5.0 45.0